11111
1m1e1
10011
10101
11111

11111
1.1e1
10011
10101
11111

11111
1.1e1
1.011
10101
11111

11111
1.1e1
1.011
1.101
11111

11111
1.1e1
1..11
1.101
11111

The mouse is trapped!!!!

End of processing
